#######o##
#oo#ooooo#
#o##o###o#
#oo#o#ooo#
#o####o###
#o#oooooo#
#oox###o##
#o###oooo#
#o#ooo##o#
##########
